attire (n - əˈtaɪər) trang phục | a formal (trang trọng) attire
enlarged (adj - ɪnˈlɑːrdʒd) phóng to/mở rộng | an enlarged photo
fiercely (adj - fɪrsli) quyết liệt | competed fiercely in the final match
press conference (n - ˈpres ˌkɑːnfərəns) họp báo
midday (n - ˌmɪdˈdeɪ) trưa | we met at midday for lunch
gathering (n - ˈɡæðərɪŋ) cuộc họp mặt | a family gathering
groundbreaking (adj - ˈɡraʊndˌbreɪkɪŋ) đột phá | a groundbreaking piece of research
malfunction (n - ˌmælˈfʌŋkʃn) sự cố | the cả had a malfunction and needed to be repaired
acceptance (n - əkˈseptəns) nhận giải | at the award acceptance
garment (n - ˈɡɑːrmənt) hàng may mặc | the factory produces high-quality garment
embark (v - ɪmˈbɑːrk) bắt đầu | they embarked on new project
gratitude (n - ˈɡrætɪtuːd) lòng biết ơn | her gratitude
hail (v - heɪl) đến từ | he hails from a small town
up-to-date (adj - ˌʌp tə ˈdeɪt) hiện đại | up-to-date equipment
unoccupied (adj - ˌʌnˈɑːkjəˌpaɪd) bỏ trống | an unoccupied house
pleasantly (adv - ˈplezəntli) dễ chịu | a pleasantly cool room
confidential (adj - ˌkɑːnfɪˈdenʃl) bí mật | the documents are confidential
rewiring (n - ˌriːˈwaɪərɪŋ) đi dây lại | the building need to rewiring to meet safety standards
world-class (adj - ˌwɜːrldˈklæs) đẳng cấp thế giới | a world-class athlete 
fragile (adj - ˈfrædʒl) dễ vỡ | marked as fragile
former (adj - ˈfɔːrmər) trước đây | She is a former employee of the company
Mongolia (n - mɒŋˈɡoʊliə) Mông Cổ 
warmly (adv - ˈwɔːrmli) nhiệt liệt | They were warmly welcome by the host
scope (n - skoʊp) phạm vi | plenty of scope for improvement 
pad (n - pæd) tấm lót | tấm lót chuột
delicate (adj - ˈdelɪkət) mong manh, dễ vỡ | the vase is very delicate
novelist (n - ˈnɑːvəlɪst) tiểu thuyết gia
wellness (n - ˈwelnəs) chăm sóc sức khỏe | a wellness centre offering yoga
trail (n - treɪl) đường mòn | we hiked along the mountain trail
trainee (n - ˌtreɪˈniː) thực tập sinh
odorless (adj - ˈoʊdər·ləs) không mùi | an odorless liquid
inspection (n - ɪnˈspekʃn) kiểm tra | teh safety inspection
appetizer (n - ˈæpɪtaɪzər) món khai vị 
specialize (v - ˈspeʃəlaɪz) chuyên về | He specialized in criminal law
inspector (n - ɪnˈspektər) thanh tra
attorney (n - əˈtɜːrni) luật sư
glad (adj - ɡlæd) vui | I’m so glad.
demonstration (n - ˌdemənˈstreɪʃn) việc trình bày, chứng minh, cuộc biểu tình, trình diễn
designate (adj - ˈdezɪɡnɪt) được chỉ định | designated seats
transfer (v - trænsˈfɜːr) chuyển | he was transferred to new branch last month
simplicity (n - sɪmˈplɪsəti) sự đơn giản 
editor-in-chief (n - ˌedɪtər ɪn ˈtʃiːf) tổng biên tập
capital (n - ˈkæpɪtl) nguồn vốn | the company raised capital through an IPO
corporate (adj - ˈkɔːrpərət) công ty | corporate culture
banquet (n - ˈbæŋkwɪt) bữa tiệc 
adaptability (n - əˌdæptəˈbɪləti) khả năng thích ứng
pertinent (adj - ˈpɜːrtnənt) thích hợp
portfolio (n - pɔːrtˈfoʊlioʊ) danh mục đầu tư
chairperson (n - ˈtʃerpɜːrsn) chủ tịch 
compensate (v - ˈkɑːmpenseɪt) bồi thường
angles (n - ˈæŋɡlz) góc độ | the photographer tried different angles.
multilingual (adj - ˌmʌltiˈlɪŋɡwəl) đa ngôn ngữ
expedited (adj - ˈekspɪdaɪtɪd) khẩn trương | expedited shipping
footage (n - ˈfʊtɪdʒ) cảnh quay 
appoint (v - əˈpɔɪnt) bổ nhiệm | she was appointed as the new manager
sew (v - soʊ) may | My mother taught me how to sew. 
cosmetic (n - kɑːzˈmetɪk) mỹ phẩm | she bought some new cosmetic
endeavour (n - ɪnˈdevər) cố gắng | 
apparel (n - əˈpærəl) trang phục
noticeable (adj - ˈnoʊtɪsəbl) đáng chú ý
points of sale (n - ˈpɔɪnts əv ˈseɪl) điểm bán hàng
entryway (n - ˈentriweɪ) lối vào
lenses (n - ˈlenzɪz) ống kính
tenure (n - ˈtenjər) nhiệm kỳ
upturn (n - ˈʌptɜːrn) đi lên
peak (v - piːk) cao điểm, đạt đỉnh | Oil production peaked in the early 1980s.
ground floor (n - ˌɡraʊnd ˈflɔːr) tầng trệt
panel (n - ˈpænl) hội đồng, ban, bệ | interview panel, advisory panel
incorporation (n - ɪnˌkɔːrpəˈreɪʃn) tổ chức, sự kết hợp
vice-president (n - ˌvaɪs ˈprezɪdənt) phó giám đốc
authority (n - əˈθɔːrəti) chính quyền, cơ quan
attendee (n - əˌtenˈdiː) người tham dự
arise (v - əˈraɪz) phát sinh | injuries arising out of a road accident 'thương tích do tai nạn giao thông'
audit (n - ˈɔːdɪt) kiểm toán
vendor (n - ˈvendər) nhà cung cấp | software vendors
journalist (n - ˈdʒɜːrnəlɪst) nhà báo | a freelance journalist
drill (n - drɪl) cái khoan
role-play (v - ˈroʊl pleɪ) đóng vai | The team role-played working as a company.
manuscript (n - ˈmænjuskrɪpt) bản thảo
mentoring (n - ˈmentɔːrɪŋ) tư vấn | a mentoring programm
entry (n - ˈentri) bài dự thi | The sender of the first correct entry drawn will win 'Người gửi bài dự thi đúng đầu tiên được rút ra sẽ giành chiến thắng'
leadership (n - ˈliːdərʃɪp) lãnh đạo | a leadership role
mindful (adj - ˈmaɪndfl) lưu tâm | mindful of our responsibilities
restoration (n - ˌrestəˈreɪʃn) phục hồi | the restoration of diplomatic 'ngoại giao' relations between the two countries
invoice (n - ˈɪnvɔɪs) hóa đơn | invoice for the goods
untapped (adj - ˌʌnˈtæpt) chưa được khai thác
outlet (n - ˈaʊtlet) ổ cắm | power outlet adaptors
prestigious (adj - preˈstiːdʒəs) uy tín | a prestigious landmark in the city

fireworks (n - ˈfaɪərˌwɜːrks) pháo hoa | The New Year's Eve fireworks were spectacular.
routinely (adv - ruːˈtiːnli) thường xuyên | He routinely checks his email every morning.
occasionally (adv - əˈkeɪʒnəli) thỉnh thoảng | She occasionally visits her grandparents on weekends.
upturn (n - ˈʌptɜːrn) sự gia tăng, sự đi lên | The company saw an upturn in sales last quarter.
excelled (v - ɪkˈseld) xuất sắc | She excelled in her studies and graduated at the top of her class.
tenure (n - ˈtenjər) nhiệm kỳ | His tenure as CEO lasted for over a decade.
promptly (adv - ˈprɑːmptli) kịp thời | The technician arrived promptly to fix the issue.
menu offerings (n - ˈmenjuː ˈɔːfərɪŋz) thực đơn | The restaurant's menu offerings include a variety of vegan options.
dominated (v - ˈdɑːmɪˌneɪtɪd) thống trị | The team dominated the league with their outstanding performance.
accessory (n - əkˈsesəri) phụ kiện | She bought a matching accessory for her dress.
incorporation (n - ɪnˌkɔːrpəˈreɪʃn) thành lập, tổ chức, sự kết hợp | The incorporation of new technology improved the company's efficiency.
submission (n - səbˈmɪʃn) trình/ trình đơn | The deadline for the submission of applications is next Friday.
