10
10
utilization(n - ˌjuːtələˈzeɪʃn)việc sử dụng
asymmetric(adj - ˌeɪsɪˈmetrɪk)bất đối xứng
homemaker(n - ˈhəʊmmeɪkər)nội trợ
commitment(n - kəˈmɪtmənt)cam kết
broom(n - bruːm)chổi
mower(n - ˈməʊər)máy cắt cỏ
spottter(n - ˈspɑːtər)người giám sát
oversee(v - ˌəʊvərˈsiː)giám sát
cover letter(n - ˈkʌvər letər)thư xin việc
debit(n - ˈdebɪt)ghi nợ
thermostat(n - ˈθɜːrməstæt)máy điều nhiệt
bulletin(n - ˈbʊlətɪn)bản thông báo
deposit(n - dɪˈpɑːzɪt)gửi, gửi tiền
versatile(adj - ˈvɜːrsətl) linh hoạt
starve(v - stɑːrv)chết đói
termination(n - ˌtɜːrmɪˈneɪʃn)chấm dứt
fair(adj - fer)hội chợ
pool(n - puːl)bida
tie(v - taɪ)hòa 
obstruct(v - əbˈstrʌkt)cản trở
spoil(v - spɔɪl)làm hỏng
foreground(n - ˈfɔːrɡraʊnd)phía trước
intended(adj - ɪnˈtendɪd)dự định
pharmacy(n - ˈfɑːrməsi)nhà thuốc
depict(v - dɪˈpɪkt)miêu tả
particularly(adv - pərˈtɪkjələrli)đặc biệt
publication(n - ˌpʌblɪˈkeɪʃn)ấn phẩm
raise(v - reɪz)nâng lên
hood(n - hʊd)mui  xe
toaster(n - ˈtəʊstər)lò nướng bánh mỳ
slash(v - slæʃ)giảm, cắt giảm 
restraint(n - rɪˈstreɪnt)kiềm chế, hạn chế
fate(n - feɪt)số phận
reinstate(v - ˌriːɪnˈsteɪt)phục hồi
triggered(v - ˈtrɪɡər)kích hoạt
overlook(v - ˌəʊvərˈlʊk)nhìn ra 
hit(n - hɪt)là điểm nhấn
finance(n - ˈfaɪnæns)tài trợ
attributable(adj - əˈtrɪbjətəbl)thuộc về
assemble(v - əˈsembl)lắp ráp
pylon(n - ˈpaɪlən)cột, trụ
concrete(adj - ˈkɑːnkriːt)bê tông
blend(v - blend)hòa hợp
speciality(n - ˌspeʃiˈæləti)chuyên môn
vacate(v - ˈveɪkeɪt)bỏ trống, rời đi
renovation(n - ˌrenəˈveɪʃn)cải tạo
relocate(v - ˌriːˈləʊkeɪt)chuyển vị trí, tái định cư, di dời
herb(n - hɜːrb)thảo mộc
barn(n - bɑːrn)chuồng
pesticide(n - ˈpestɪsaɪd)thuốc trừ sâu
herbicides(n - ˈhɜːrbɪsaɪd)thuốc diệt cỏ
flyer(n - ˈflaɪər)tờ rơi
newsletter(n - ˈnuːzletər)bản tin
host(v - həʊst)tổ chức
rental(n - ˈrentl)cho thuê
access(v - ˈækses)truy cập, kết nối
utility(n - juːˈtɪləti)tiện ích
potentially(adv - pəˈtenʃəli)có thể
inquire(v - ɪnˈkwaɪər)hỏi thăm, hỏi
upkeep(n - ˈʌpkiːp)bảo dưỡng
residential(adj - ˌrezɪˈdenʃl)khu dân cư
residence(n - ˈrezɪdəns)nơi cư trú
prefer(v - prɪˈfɜːr)ưu tiên, ưa chuộng
last(v - læst)tồn tại, kéo dài
kitchenware(n - ˈkɪtʃɪnwer)đồ dùng nhà bếp
caterer(n - ˈkeɪtərər)người phục vụ đồ ăn
straightforward(adj - ˌstreɪtˈfɔːrwərd)đơn giản
exceptionally(adv - ɪkˈsepʃənəli)đặc biệt
portable(adj - ˈpɔːrtəbl)cầm tay
powerful(adj - ˈpaʊərfl)mạnh mẽ
motor(n - ˈməʊtər)động cơ
reassurance(n - ˌriːəˈʃʊrəns)sự đảm bảo, sự an tâm, sự trấn an
durable(adj - ˈdʊrəbl)bền
optional(adj - ˈɑːpʃənl)tùy chọn
inaugurate(v - ɪˈnɔːɡjəreɪt)khánh thành
refurbish(v - ˌriːˈfɜːrbɪʃ)tân trang
arena(n - əˈriːnə)đấu trường
incentive(n - ɪnˈsentɪv)sự khích lệ
reserve(v - rɪˈzɜːrv)dành cho
look(n - lʊk)ngoại hình
gotta(v - ˈɡɑːtə)cần phải
youngster(n - ˈjʌŋstər)người trẻ
unfit(adj - ʌnˈfɪt)thừa cân
increasingly(adv - ɪnˈkriːsɪŋli)ngày càng
lateness(n - ˈleɪtnəs)sự muộn màng, sự chậm trễ
showcase(n - ˈʃəʊkeɪs)buổi giới thiệu
favorable, favorably(adj, adv - ˈfeɪvərəbl)thuận lợi, tốt
scattered(adj - ˈskætərd)rải rác
planner(n - ˈplænər)người lập kế hoạch
prototype(n - ˈprəʊtətaɪp)mẫu
finalize(v - ˈfaɪnəlaɪz)hoàn thiện
own(v - əʊn)sở hữu
adjustable(adj - əˈdʒʌstəbl)có thể điều chỉnh
orchard(n - ˈɔːrtʃərd)vường cây ăn quả
pear(n - per)lê
nearby(adj - ˌnɪrˈbaɪ)gần đây 
end(file)