## Test 5th
in case: phòng khi
in case of: trong trường hợp
outperform: vượt trội
progressively: ngày càng
in addition to: ngoài ra còn có/ngoài ra
typically: thông thường
slightly: nhẹ nhàng
reside: cư trú
residential: thuộc khu dân cư
affiliate: liên kết
occatinoal: thỉnh thoảng
all of whom: tất cả những người mà
barring: ngoại trừ
enacted: ban hành
engaged: tham gia |  They were engaged in conversation.
nominate: đề cử
subsidiary: công ty con
spectator: khán giả
turnover: doanh thu
along: dọc theo
stacked: xếp chồng lên nhau
Bikes are propped against a railing: những chiếc xe đạp được chống vào lan can
A menu is being handed to a customer: Một thực đơn đang được đưa cho khách hàng.
One man has crossed his arms: Một người đàn ông đã khoanh tay.
The table has been cleared of cups: Cái bàn đã được dọn sạch cốc chén.
A piece of luggage is being unzipped: Một chiếc hành lý đang được mở khóa kéo.
A man is buttoning up a dress shirt: Một người đàn ông đang cài cúc áo sơ mi.
A potted plant is standing next to the closet: Một chậu cây đứng cạnh tủ quần áo.
A man is twisting a belt into a coil: Một người đàn ông đang xoắn một chiếc thắt lưng thành vòng tròn.
when is the press conference `going to get underway`:  cuộc họp báo tiến hành khi nào
Isn't Alice transferring to the Orleans branch? alice không chuyển đến chi nhánh Orlean sao?
it's unlikely: khả năng cao là không
they're `getting raises`: được tăng lương
blueprint: bản thiết kế
It's located just past the courthouse: nó nằm ngay phía sau tòa án
weren't customers notified about the increase in subscription rates: Khách hàng không được thông báo về mức tăng giá đăng ký sao?
the new fashion line: dòng thời trang mới
we've been selling them `for quite a while`: chúng tôi đã bán chúng được một khoảng thời gian rồi
accumulation: sự tích lũy
statements: báo cáo
a picture I took: bức ảnh mà tôi chụp
He is stepping down as head copywriter: rời vị trí trưởng copywritter
a dedicated employee: nhân viên tận tâm
excursion: chuyến tham quan
conference room: phòng họp/hội nghị
conference hall: hội trường
I'm not supposed to ... : tôi không được phép ...
I'm `in charge of` the company's safety department: t phụ trách phòng an toàn của công ty
occupational: lao động
quite a few: có khá nhiều
precuationary: phòng ngừa
our office is `running low on some supplies`: văn phòng chúng ta đang hết một số vật phẩm
packs of folders:  bìa đựng tài liệu
your order qualifies for the bulk rates: đơn hàng của m đủ điều kiện cho mức giá số lượng lớn
It's essential that `everything be taken care` of before then: điều cần thiết là `mọi thứ phải được xử lý` trước đó
light bulb: bóng đèn
light emitting diode products: sản phẩm đi ốt phát sáng
but i don't think it highlights our product's competative attributes enough: Nhưng t ko nghĩ nó highlight đủ các thuộc tính cạnh tranh của sản phẩm
big tear: mảng rách lớn
what a shame: thật đáng tiếc
securely: chắc chắn
the product `brochure`: `tờ rơi`  giới thiệu sản phẩm
draft: bản nháp
fond: thích
beforehand: trước đó
Harris Kitchen is within the vicinty of the gallery: ... gần khu vực trưng bày?
the time sheet: bảng chấm công
how odd: lạ thật
business trip: chuyến công tác
later this afternoon: cuối buổi chiều nay
be briefed: được thông báo
I'm also gonna `bring up` ... : t cũng sẽ `đề cập` đến các bình luận một khách hàng gần đây đã chia sẻ
aside: ngoài
less-than-ideal: kém lý tưởng
heading into: tiến vào
heavy traffic: giao thông đông đúc
northbound: hướng bắc
elsewhere: ở nơi khách
routine: định kỳ
backups: ùn tắc
commute: đi lại
certificate course: khóa học được cấp chứng chỉ
tax return: tờ khai thuế
file (v): nộp
state and fereral: tiểu bang và liên bang
carry: cung cấp
no matter: bất kể
gear: thiết bị
stock: kho
litter: rác
acquisition: việc mua lại
deal: thỏa thuận
consolidation: sự hợp nhất
revenues are still down a bit `from earlier this year`: doanh thu vẫn giảm một chút `so với đầu năm nay`
the charges `you made to your company credit` card in London last month: các khoản phí mà `m đã thực hiện đối với thẻ tín dụng công ty` ...
the scans of the statements: scan của bản sao kê
assignment: phân công, bài tập
relocation: di dời
rewards are available in exchange: những phần thưởng vẫn có sẵn để đổi
special promotion: khuyến mãi đặc biệt
regardless of: bất kể
convey: chuyển giao
consequently: do đó
the following month: tháng tiếp theo
redo: cải tạo
city official close to selecting developers for downtown building: các quan chức thành phố gần chọn được các nhà phát triển cho tòa nhà trung tâm
stipulated: đã quy định
the firm left in the running: các hãng còn lại trong cuộc đua
remodeling: cải tạo
if all goes well: nếu mọi thứ suôn sẻ
draw up an agreement: soạn thảo một thỏa thuận
preceding: trước đó
forthcoming: sắp tới
compelling: hấp dẫn
all of our communications: tất cả thông tin liên lạc
with good gas mileage: mức tiêu thụ gas tốt
dents: vết lõm
cable news station: đài truyền hình cáp
anchor: biên tập viên
taking over: thay thiết
headline: tiêu đề
broadcast: chương trình phát sóng
the head of CTT new: người đứng đầu của ...
newcaster: biên tập viên
a true investigate spirti: tinh thần điều tra thật sự
an article of clothing: món quần áo
dominaiton: khoản quyên góp
gratefully: một cách biết ơn
also arrange guided visits: sắp xếp các chuyến tham quan được hướng dẫn
a flat fee: khoản phí cố định
biographies: tiểu sử
inhabitant: cư dân
boutique: cửa hàng
tins: thiếc
proceeds: số tiền
go toward: hướng tới việc
crew leader: trưởng nhóm công nhân (trưởng nhóm)
five-story structure: cấu trúc 5 tầng
turn up at our location: đến
nutritious: bổ dưỡng
accompaiments: món ăn kèm
cast and crew: diễn viên và đoàn làm vphim
premiere: ra mắt
signs listing assigned workspaces: biển liệt kê không gian làm việc được phân công
freelace illustrator: họa sĩ minh họa tự do
job application: đơn xin việc
broken up into 12 different stories: chia thành 12 ...
chief operation officer = chief operation = giám đốc điều hành
pension scheme: hệ thống hưu trí
communicate your preference: đưa ra ý kiến của bạn
as well as: ngoài
amount: số tiền
if there is a time that `works` best for you: nếu có thời gian `phù hợp` với bạn
deducted: được trừ
the sum that workers can put toward a pension: số tiền mà các công nhân có thể đóng vào quỹ hưu trí
the bonuses employees are given for performing well: tiền thưởng mà nhân viên ...
an extension on the deadline: gia hạn deadline
peer: đồng nghiệp
stakeholders: các bên liên quan
various sectors: nhiều ngành khác nhau
material `profession`: `nghề` vật liệu
advertisement meant for inclusion in :để đưa vào
incidentally: nhân tiện
his availability: khả năng có mặt của anh ấy ...
with whom: với những người ...
positive coverage in numerous publications: phản hổi tích cự trong nhiều ấn phẩm
amenties: sự tiện nghi
both of which: cả 2
boardroom: phòng họp
remark: phát biểu
certificates of appreciation: giấy chứng nhận khen thưởng
hand the card to you server: đưa thẻ cho người phục vụ
it hosted a large numerous tourist: nó đón lượng lớn du Khách
waterfront: ven sông
establishment: nhà hàng
recreation: giải trí
considerable significance: có ý nghĩa đáng kể
with the realm of possibility: trong phạm vi có thể
vicnity: khu vực lân cận
we can go over the Cross Media contract together: chúng ta có thể cùng xem hợp động Cross Media
right across the street: ngay bên kia đường ...
carry out: thực hiện
concluding date: ngày kết thúc